010100010001000
000001010101010
011111010101010
000001010101010
111101010100010
000101010111110
010001000100011
01111111110101G
000000000101010
111101110101010
000100010101000
010101010101111
010101010100000
010111010111110
M10000010000000
